F 2,20,2

NO ./images/textures/north/

R 800 600
SO ./images/textures/south/
WE ./images/textures/west/
S ./images/sprites/

CB ./images/textures/ceil/
FB ./images/textures/floor/
DB ./images/textures/doors/
C 220,10,23

EA ./images/textures/east/

111111111111111111111111111111111
1100000000000000000000000001111111
100000000000S0000000000000000001
10000000000000000000000000001111
10000000000000000000000011111111
111121111131111111111111111011111
1000000000000001100000000000111111
10000006000004000000000000000001
10000000000001010067598001111111
111111111111111111111111111111111