C 2,20,2


NO ./path_to_the_north_texture

R 1920 1080
SO ./path_to_the_south_texture
WE ./path_to_the_west_texture
EA ./path_to_the_east_texture
S ./path_to_the_sprite_texture


F 220,10,000



111111111111111111111
100000000011000111111111111111
10110000011100011111111111111
10010000000000000000000010001111111
10110000011100000000000000000100011
100000000011000001110111100000000011
11110111111111011100000010001111111
111101111111110111010100100011
110000001101010111000000100001
1000200000000000110000001000111
10000000000000001101010010001
11000000110101011111011110N01
1111011111111111111111111011111111111
111111111111111111111111111