F 2,20,2

NO ./images/textures/north/

R 800 600
SO ./images/textures/south/
WE ./images/textures/west/
S ./images/sprites/



C 220,10,23

EA ./images/textures/east/

1111111111111111111111111
1E00000000110000000000001
1011110001110000000000001
1010000000000100000000001
1010000000000000022200001
1000000000020000000000001
1111000000000000000000001
1000000000000000000000001
1000000000002000000000001
1000000000000000110000001
1000000000000000110101001
1100000011010101111101111
1111011111111111111101111
111101111111  11110000001
1100000111      110000001
1000000011      110000001
1000000011111111111000101
1000000011111111111101001
1100000111000111111000111
1000200010000011010101001
1002000000000000000000001
1000200010000011010101001
1100000111001111111000111111111
110000011101100111111000111
1111111111111111111111111
111
111