F 2,20,2

NO ./images/textures/north/

R 1200 1200
SO ./images/textures/south/
WE ./images/textures/west/
S ./images/sprites/



C 220,10,23

EA ./images/textures/east/

111111111111111111111111111111111
1000000000000000000000000001111111
100000000000000000000000000000W1
1000000000000000000000000001111111
111111111111111111111111111111111