F 2,20,2

NO ./images/textures/north/

R 800 600
SO ./images/textures/south/
WE ./images/textures/west/
S ./images/sprites/

CB ./images/textures/ceil/
FB ./images/textures/floor/

C 220,10,23

EA ./images/textures/east/

111111111111111111111111111111111
1000000000000001100000000001111111
100000020W0000000000000000000001
100000000000010100000000001111111
111111111111111111111111111111111