F 2,20,2

NO ./path_to_the_north_texture

R 800 600
SO ./path_to_the_south_texture
WE ./path_to_the_west_texture
S ./path_to_the_sprite_texture


C 220,10,23

EA ./path_to_the_east_texture

111111111111
101011111111
100000000101
10E000000001
100000000001
111111111111