F 2,20,2

NO ./images/textures/north/

R 800 600
SO ./images/textures/south/
WE ./images/textures/west/
S ./images/sprites/



C 220,10,23

EA ./images/textures/east/

        111111111   111111111111111111  1111111
        1N0000001   1100000000001111   11101  1
   1    11011000111111000002000011   111111111
        1101000000000000000000001     11100111
111111111011000001110000000000001     11111111
   1000000000110000011101111111111111
1111011111111101111110001000111
111101111111110111  11010010001111 1111
1100000001101010111110000100011
1000200000000000110000001000111
10000000000000001101010010001
110000011101010111101111000111
11110111 1110101 101111010001
11111111 1111111 111111111111