F 2,20,2

NO ./images/textures/north/

R 800 600
SO ./images/textures/south/
WE ./images/textures/west/
S ./images/sprites/

CB ./images/textures/ceil/
FB ./images/textures/floor/
DB ./images/textures/door/
C 220,10,23

EA ./images/textures/east/

        1111111111111111111111111
        1600900070110009009409091
        1000004000910004404404091
        1500000000020000440440491
111111111000004000910009009049091
188836000000004051111111111111111
17771000000000511160000916061
11111121111111111100000020001
11700000000000011100000010081
15004000004000001140000010501
10000000400000000201010915051
1100000111000001111151111000111
11117111 1115951 101111010N01
11111111 1111111 111111111111