C 2,20,2

NO ./path_to_the_north_texture

R 320 200
SO ./path_to_the_south_texture
WE ./path_to_the_west_texture
S ./path_to_the_sprite_texture


F 220,10,23

EA ./path_to_the_east_texture

111111111111
101110111111
100000000001
100000E10011
100000000001
111111111111