F 2,20,2

NO ./images/textures/north/

R 252 231
SO ./images/textures/south/
WE ./images/textures/west/
S ./images/sprites/

CB ./images/textures/ceil/
FB ./images/textures/floor/
DB ./images/textures/door/
C 220,10,23

EA ./images/textures/east/

111111111111111111111111111111111
110000400000000000000000001111111
100000000000E0000000000000000001
111111111111111111111111111111111