F 2,20,2

NO ./images/textures/north/

R 800 600
SO ./images/textures/south/
WE ./images/textures/west/
S ./images/sprites/



C 220,10,23

EA ./images/textures/east/

111111111111111111111111111111111
1000020000000000100200000001111111
100000000000E000000000000001001
10002000020001000000000001111111
111111111111111111111111111111111